5 16 7 6 5 5 4 10 1 11
19 13 12 8 4 3 2 1 10 6
1 3 9 10 3 3 2 0 7 0
0 14 2 7 11 6 3 4 8 9
7 3 1 4 13 12 18 19 7 11
4 6 4 0 11 12 19 3 16 16
5 19 3 17 17 6 18 10 2 5
15 12 3 9 8 4 1 0 11 18
17 13 7 20 12 20 3 2 18 3
1 13 18 6 5 4 3 4 18 5
