6 9 2 2 3
5 4 2 7 0
5 4 3 1 4
4 3 4 5 8
2 1 0 7 6
