17 16 11 14 18 5 6 12 2 16
9 10 15 2 13 13 10 3 4 19
20 8 3 2 12 10 18 12 15 16
7 7 6 1 9 11 17 8 9 11
6 8 4 2 0 8 7 2 1 10
9 5 3 10 2 3 6 4 3 0
0 2 4 6 14 10 3 5 18 18
1 4 3 16 16 3 19 15 19 17
7 6 5 1 9 15 17 20 16 18
8 9 10 11 12 13 14 15 21 22
