132 155 92 3 182 59 15 158 5 52 134 176 85 131 69 41 193 66 123 70 181 58 40 156 27 46 60 12 27 132 107 132 47 40 121 0 146 7 21 114 199 101 115 126 49 55 131 28 82 138
49 7 179 150 161 18 56 127 20 111 197 24 183 4 99 60 126 0 108 161 116 171 101 195 108 200 118 48 184 118 45 56 104 53 73 110 11 9 199 12 143 170 149 193 3 158 27 112 85 44
144 172 65 31 6 50 197 154 26 73 193 33 60 68 155 66 126 30 57 136 79 170 111 196 85 83 110 98 36 184 64 44 10 106 46 93 165 3 101 44 56 143 42 52 92 108 16 87 78 24
103 163 94 42 65 104 95 78 104 117 44 52 167 83 104 133 74 13 131 189 174 22 51 148 96 139 16 120 52 26 11 45 125 84 61 105 65 4 128 111 117 154 82 30 31 140 187 155 136 171
15 82 183 79 184 134 101 108 198 175 139 13 186 139 109 105 2 129 22 150 87 76 77 120 75 9 108 27 150 24 102 142 0 1 54 11 12 162 23 136 125 141 104 21 82 63 34 71 153 74
172 10 88 124 38 149 144 148 127 9 17 190 31 17 20 1 68 148 53 166 187 76 111 194 138 176 200 83 88 14 11 10 3 2 9 10 13 14 38 139 136 146 187 193 70 0 76 177 183 86
69 139 142 147 102 23 59 136 51 14 119 138 27 59 100 81 113 116 99 193 45 72 69 47 113 165 199 187 145 13 12 9 4 7 8 9 143 15 16 17 155 90 122 0 88 30 66 149 150 99
147 160 176 14 153 89 17 30 73 13 150 35 87 130 143 74 146 107 101 38 150 196 3 83 197 122 10 156 95 16 65 8 5 6 11 10 137 56 77 18 79 15 9 32 79 24 176 69 64 67
43 166 181 59 129 192 4 76 126 167 142 2 119 116 46 35 97 147 193 24 118 80 22 96 132 6 153 48 116 169 145 7 6 79 190 183 183 90 195 20 120 71 96 32 66 41 86 71 122 163
156 55 81 5 170 190 63 68 94 128 183 121 6 151 65 193 71 200 7 11 71 51 34 62 118 97 106 24 181 140 27 115 152 84 168 69 42 141 124 101 7 104 50 94 109 31 151 26 178 153
187 119 13 67 83 80 23 115 68 21 142 149 7 171 81 134 106 39 189 26 68 45 179 45 140 193 23 139 197 129 81 16 131 25 111 63 200 146 111 140 17 170 165 149 55 103 52 30 1 52
43 123 76 145 194 116 37 26 32 92 36 17 171 50 42 146 184 122 66 138 159 60 164 180 46 132 171 163 99 40 192 50 173 109 98 18 61 188 49 200 144 14 144 73 80 169 183 188 23 30
155 189 40 116 16 93 1 139 100 194 100 20 5 98 187 7 68 155 65 116 47 50 100 24 187 32 172 78 128 53 127 173 116 19 44 151 136 7 55 173 64 173 113 23 161 189 11 141 113 183
5 138 63 163 88 199 0 121 120 199 139 138 44 102 19 79 196 140 121 94 151 55 118 85 132 166 155 196 55 12 40 40 150 51 53 187 174 5 184 68 71 140 10 104 122 43 48 33 26 83
38 175 43 179 148 114 118 101 65 78 200 142 79 172 8 57 183 68 125 56 74 135 191 25 108 88 168 128 16 43 184 129 126 36 94 195 58 113 98 129 107 124 124 51 190 63 98 78 104 193
179 190 181 14 114 58 65 140 182 90 79 9 177 166 112 5 25 163 156 166 139 73 161 121 17 142 170 58 72 145 165 80 161 197 19 113 25 46 173 68 96 79 30 133 137 38 3 13 44 70
157 33 162 199 170 30 77 176 81 105 36 188 96 165 71 148 190 72 148 114 159 8 13 28 188 117 0 1 7 8 11 153 189 198 158 151 80 85 31 143 5 108 13 73 181 93 120 159 26 14
171 104 4 7 10 14 132 91 74 59 33 65 3 193 106 23 75 74 98 103 135 70 67 21 46 74 3 2 6 9 10 175 129 61 110 152 111 147 149 192 137 111 94 32 164 97 37 18 106 164
68 110 20 21 45 109 165 156 116 39 56 52 98 144 7 27 80 51 95 32 58 103 136 186 164 26 4 151 5 4 11 119 132 140 153 77 115 181 45 63 84 139 74 158 11 74 89 105 21 183
17 18 19 22 94 26 27 30 60 132 124 29 13 112 168 165 183 197 136 147 171 39 88 194 111 6 5 1 2 3 66 194 185 55 36 191 16 17 18 19 22 23 24 111 173 192 74 148 118 156
16 15 77 23 24 25 28 29 87 98 29 54 134 74 194 184 43 160 104 118 145 17 37 9 8 7 111 0 3 6 7 107 114 58 13 14 15 64 11 20 21 26 25 162 87 133 3 105 104 114
143 14 15 16 17 18 19 116 171 143 46 45 194 128 70 134 71 167 24 166 54 69 90 10 11 12 28 124 4 5 8 9 10 148 12 11 82 75 75 13 71 27 28 27 28 29 30 39 110 195
191 13 16 17 18 21 20 145 44 123 87 72 70 113 11 121 24 143 76 136 39 40 20 70 41 13 65 145 135 57 147 3 11 65 9 10 183 68 104 60 53 11 29 26 27 26 31 73 129 18
11 12 15 67 114 22 91 8 19 130 142 107 153 134 84 57 11 120 95 84 12 160 19 18 15 14 59 98 157 1 195 43 51 67 8 9 10 11 12 8 76 31 30 25 26 33 32 82 67 200
10 13 14 159 51 117 2 1 39 146 134 34 41 16 140 14 11 64 35 166 89 184 107 17 16 15 16 26 72 150 150 105 182 6 7 8 9 10 13 64 33 32 23 24 25 34 35 3 174 58
9 8 7 6 5 4 3 0 37 140 172 17 14 40 74 6 91 99 145 110 19 121 42 18 19 18 17 154 61 165 118 105 50 5 6 7 8 11 14 15 34 35 22 187 60 36 69 92 81 181
128 3 61 170 106 165 106 197 178 62 0 12 13 69 171 105 149 122 159 56 86 63 57 71 20 21 41 171 88 47 93 79 194 4 5 16 17 12 100 16 17 20 21 48 56 88 35 96 43 63
198 108 118 113 91 13 134 140 170 79 10 11 133 196 67 78 65 173 95 53 74 125 72 154 14 22 23 196 0 137 81 1 2 3 196 15 14 13 14 32 18 19 53 23 187 151 172 179 188 139
142 118 133 200 21 146 123 28 97 190 9 47 108 165 111 70 10 158 53 143 187 189 192 167 3 57 24 25 171 63 123 0 100 191 31 170 175 16 15 44 41 119 134 24 117 35 43 175 91 84
197 93 59 151 2 190 26 87 76 187 8 181 198 19 72 175 14 171 172 1 119 34 119 195 103 28 27 26 171 131 130 177 119 188 159 132 108 38 39 107 114 179 192 115 183 154 136 99 98 183
67 13 61 131 17 18 25 24 23 6 7 103 85 195 181 129 12 13 168 1 0 63 9 134 42 29 124 165 31 155 189 103 63 176 140 60 199 196 102 84 59 90 157 150 34 67 2 113 66 190
43 91 113 180 16 19 20 21 22 5 172 90 77 186 187 115 11 10 9 2 3 86 163 27 41 189 60 166 46 187 83 84 56 190 193 70 110 159 93 101 127 127 118 59 13 170 37 102 46 13
91 84 32 151 15 94 194 0 1 4 21 64 0 186 98 151 184 32 8 5 4 178 67 143 176 146 51 7 156 18 30 165 185 69 6 54 187 90 55 89 152 176 67 88 110 100 1 13 123 16
140 60 52 101 14 13 12 11 2 3 128 184 127 113 110 46 88 177 7 6 182 185 30 108 48 0 25 34 161 116 40 137 195 133 176 158 90 45 69 84 132 41 172 67 27 27 173 2 21 15
80 178 43 195 56 116 76 10 5 4 7 8 9 10 80 91 153 61 20 19 18 74 184 144 198 1 166 63 77 141 123 0 41 147 143 125 139 51 172 150 83 91 22 193 0 164 37 78 104 14
168 107 88 20 131 50 49 9 6 5 6 13 12 11 33 32 188 22 21 160 17 16 15 14 121 2 3 69 92 53 103 104 15 184 197 184 110 155 117 165 1 36 113 189 65 180 82 8 80 13
32 0 118 50 129 72 48 8 7 90 17 14 36 35 34 31 24 23 1 50 38 17 179 13 12 11 4 50 144 188 127 23 127 48 22 87 37 66 192 9 169 186 184 37 155 37 55 149 47 12
149 124 190 19 22 153 47 46 45 44 16 15 37 12 165 30 25 26 182 71 34 73 69 18 19 10 5 187 31 3 165 196 92 167 193 39 24 157 160 97 157 100 43 132 199 148 41 186 111 11
17 146 24 120 106 159 33 152 178 43 42 41 38 144 198 29 28 27 176 7 71 195 81 17 20 9 6 86 124 179 94 70 35 140 22 190 49 117 26 196 154 11 29 28 191 198 70 64 92 10
97 34 174 187 123 109 32 29 28 94 70 40 39 49 24 176 197 20 194 153 139 56 15 16 21 8 7 174 101 191 80 93 32 91 82 159 172 47 101 109 68 143 26 27 98 91 145 90 150 9
198 194 131 34 126 131 31 30 27 26 147 0 170 164 171 197 114 112 148 25 70 81 14 15 16 11 125 144 48 148 149 145 163 139 193 135 159 45 52 95 84 71 25 24 23 58 132 61 91 8
169 165 32 33 28 27 43 23 24 25 80 1 78 189 44 126 188 18 126 50 124 156 13 14 73 4 143 134 1 194 109 126 30 161 195 7 93 45 69 191 113 109 130 177 22 21 20 197 87 7
117 99 31 30 29 26 21 22 106 172 123 2 68 160 83 51 0 182 177 56 84 196 12 11 145 62 188 146 19 30 87 96 24 150 149 12 171 71 36 78 87 128 60 112 39 191 19 4 5 6
19 99 49 23 24 25 20 19 5 138 77 3 162 27 64 118 140 136 21 140 10 117 9 10 53 144 99 111 98 184 46 2 128 125 107 123 163 166 128 102 48 105 53 76 16 17 18 3 2 1
139 57 199 22 21 20 19 18 7 6 5 4 11 33 88 64 18 140 133 5 6 7 8 139 176 130 93 115 37 92 93 70 66 92 144 146 6 36 22 37 26 170 184 107 15 14 13 146 3 0
166 140 190 38 89 172 20 17 8 54 31 84 133 173 147 51 15 186 121 4 1 0 44 150 186 66 116 42 120 198 173 194 33 192 58 66 102 31 160 16 61 128 22 108 105 165 12 5 4 5
200 55 167 32 48 133 15 16 9 183 146 91 30 134 173 163 196 172 110 3 2 0 165 31 181 187 3 77 96 36 74 133 48 128 161 172 189 181 41 154 6 115 56 29 81 10 11 6 86 6
156 199 58 111 94 30 14 11 10 111 182 104 9 157 56 58 65 54 124 53 68 36 159 6 125 111 148 154 104 54 49 140 124 32 164 29 68 148 20 100 46 64 84 12 117 9 8 7 8 7
95 56 189 79 199 12 13 12 193 3 102 149 101 150 106 73 1 109 131 23 88 28 126 174 71 77 190 2 11 176 150 11 131 82 142 132 178 53 51 16 191 161 178 89 105 53 11 10 9 16
112 23 144 150 89 84 41 65 122 116 76 184 114 110 102 102 140 176 117 42 152 158 140 127 32 103 0 39 2 177 13 148 186 43 170 56 0 53 54 72 136 62 81 186 5 38 12 13 14 15