69 98 13 85 115 114 112 111 110 109 108 106 105 102 101 94 93 92 91 90 89 99 98 97 93 31 9 62 72 20 15 72 13 2 94 8 16 93 29 53 12 32 69 50 18 92 59 6 70 48
16 32 10 119 116 59 113 91 89 97 107 77 62 104 103 100 95 98 97 88 94 92 96 22 48 24 56 58 44 7 2 59 42 92 76 3 92 46 11 43 92 95 31 56 89 74 21 97 41 88
84 67 118 117 120 121 81 39 56 5 47 88 73 35 26 102 99 96 105 87 93 95 91 39 77 64 34 61 49 99 26 55 43 76 74 18 28 46 49 62 19 34 63 42 10 8 3 5 3 12
39 130 128 125 127 128 122 74 14 70 49 90 62 63 101 100 103 104 86 82 88 90 87 88 43 62 85 100 87 79 42 83 18 95 46 40 56 90 41 59 36 100 73 25 43 35 55 27 20 61
131 129 127 126 124 123 129 82 59 58 37 60 89 35 8 82 83 85 81 83 89 84 85 86 89 31 55 39 79 53 83 45 49 75 79 97 80 44 70 21 20 61 3 34 98 20 95 94 90 63
133 132 126 125 124 131 130 8 12 36 46 93 10 53 42 81 80 84 84 80 83 79 77 76 75 90 93 19 54 91 52 50 49 48 5 85 0 1 74 42 10 53 84 20 91 73 23 90 10 33
134 81 47 44 62 11 5 22 67 2 58 92 33 77 78 79 77 78 79 67 82 78 80 74 98 92 91 72 50 55 51 75 47 46 36 72 93 4 2 97 68 59 30 85 46 70 93 86 48 0
40 135 137 49 16 66 48 42 58 58 61 49 20 83 76 76 70 71 68 70 66 81 73 100 99 97 92 93 90 56 62 60 45 43 42 41 22 3 5 58 53 69 100 98 57 4 90 73 33 52
61 43 136 138 82 22 51 84 2 2 8 55 48 75 75 74 72 69 95 36 65 72 70 102 101 76 96 95 94 19 57 79 59 44 40 23 26 21 6 42 64 34 50 98 73 71 79 14 0 22
0 56 139 16 15 52 53 24 41 51 63 97 3 9 74 73 99 72 90 23 64 69 71 103 74 74 75 93 18 12 20 58 37 39 24 25 20 7 17 88 47 85 73 31 25 93 38 18 30 47
89 40 17 140 14 31 100 20 8 66 93 32 45 61 90 73 47 75 9 63 68 70 104 72 73 75 12 10 17 11 13 21 38 36 34 25 19 18 8 87 74 84 54 39 11 74 58 57 67 32
0 1 19 18 30 13 32 44 51 17 96 39 36 36 77 77 43 24 1 62 67 69 71 78 76 13 11 9 16 10 14 22 67 35 26 33 32 17 9 2 36 33 90 36 50 3 35 2 28 84
2 2 21 20 29 25 12 33 37 93 49 85 9 71 55 74 49 20 60 61 68 66 79 11 77 6 7 8 9 15 23 22 22 75 27 29 31 16 10 10 73 68 33 30 55 12 13 89 6 70
3 1 3 22 28 24 26 11 34 40 11 39 10 70 13 47 55 41 76 59 67 80 65 87 85 5 0 1 2 24 27 65 16 61 28 30 5 49 15 11 12 5 85 61 87 11 14 89 75 14
4 0 4 64 23 27 10 35 39 41 65 67 43 1 96 14 46 37 58 56 63 64 81 88 86 84 4 3 44 26 25 28 69 22 7 79 96 84 5 14 13 19 40 44 45 10 15 94 5 36
5 11 6 5 45 9 36 44 38 42 99 41 23 10 44 84 89 11 37 57 55 62 61 82 83 53 47 43 45 10 29 42 31 76 0 41 99 33 90 94 87 8 43 38 46 9 18 16 98 58
10 6 12 7 8 15 18 37 43 16 13 24 35 32 56 4 19 11 20 65 47 54 60 51 52 48 54 46 42 31 61 30 32 45 42 43 40 84 51 35 67 42 39 37 7 8 19 17 1 47
46 9 7 13 14 16 17 19 13 44 5 20 96 84 95 32 66 59 95 57 3 53 52 59 50 49 55 37 41 35 10 33 46 49 44 39 38 34 27 77 25 41 40 36 22 6 20 88 44 9
37 36 8 32 31 23 22 20 1 64 45 68 90 27 86 2 92 14 37 13 59 46 36 56 58 57 56 40 36 37 34 54 48 47 50 4 37 26 28 26 73 98 35 23 5 21 28 55 55 53
38 35 33 28 30 25 24 21 63 53 6 55 93 55 52 16 51 71 79 68 4 81 5 93 66 6 51 39 38 4 58 95 4 51 91 36 30 29 23 25 35 32 34 4 24 6 7 92 71 26
39 34 10 29 27 26 52 33 34 87 33 92 13 4 67 37 74 93 33 47 11 6 60 84 38 80 83 21 12 4 55 83 14 64 35 34 31 69 22 24 31 33 29 2 3 25 8 3 52 46
8 9 0 11 28 37 32 34 96 40 41 86 87 88 55 68 13 86 94 48 58 57 59 82 2 6 83 25 0 8 59 52 4 83 74 34 33 32 21 82 69 30 1 28 26 9 10 89 30 71
5 7 3 1 12 29 30 31 35 39 37 42 46 47 79 90 87 75 63 64 48 60 57 63 87 51 15 9 79 8 38 79 88 14 2 36 27 20 12 71 57 24 44 0 27 11 40 47 54 73
6 4 18 2 37 13 15 16 17 36 38 43 45 48 90 90 72 70 75 5 39 56 41 24 89 34 70 91 98 90 57 98 92 43 46 15 61 90 19 18 17 3 99 39 12 73 39 24 14 27
62 26 64 79 9 14 24 23 18 8 62 13 44 49 51 82 98 28 79 25 49 35 11 83 10 82 46 3 95 87 5 56 27 55 76 64 43 70 86 28 17 74 15 13 45 55 43 11 76 2
30 67 65 64 78 25 22 20 19 11 59 97 49 50 54 52 93 84 61 55 89 7 38 0 82 71 97 44 38 65 46 61 76 15 63 22 52 59 54 52 61 16 32 14 3 19 57 66 58 6
3 19 75 83 28 27 26 21 24 97 31 97 96 42 53 55 56 79 24 36 73 47 71 76 55 76 19 52 54 20 73 41 68 92 33 0 58 37 51 9 54 32 61 38 85 58 75 9 40 9
95 15 87 88 29 89 20 4 53 65 85 67 56 7 54 64 57 59 82 10 46 63 63 72 4 78 87 96 51 0 53 7 76 77 51 12 64 8 79 32 19 33 92 72 92 38 54 24 74 9
99 16 18 32 31 30 49 56 70 83 11 27 24 64 5 62 58 60 83 67 52 58 40 70 57 100 9 9 10 68 5 95 12 59 68 28 73 88 45 81 62 51 46 30 24 52 39 3 79 53
38 37 35 32 34 82 65 98 72 34 54 71 65 5 63 51 61 29 72 89 91 28 84 83 82 72 42 9 36 27 97 0 5 10 23 3 57 62 70 93 22 44 73 13 68 14 98 5 11 20
39 36 33 34 68 22 43 1 4 55 7 8 66 7 87 59 49 100 7 94 50 45 50 38 63 35 24 43 88 57 99 99 68 29 2 86 1 82 52 12 57 86 83 85 15 8 67 34 54 14
41 40 80 87 5 82 3 74 8 78 31 87 67 68 95 33 3 0 39 39 30 79 8 59 26 1 23 11 59 4 25 59 25 96 50 31 38 35 64 1 43 10 57 42 95 58 34 28 77 98
42 63 8 40 89 89 72 24 54 98 63 25 69 33 59 9 61 35 75 36 47 6 15 69 82 78 21 35 0 52 66 9 75 55 97 58 78 3 10 34 41 36 35 36 2 96 89 78 94 3
43 44 95 95 33 92 34 18 97 46 11 7 80 64 85 75 59 100 92 2 57 21 31 32 26 61 94 95 10 54 35 23 1 46 81 17 70 74 44 71 51 35 24 61 7 59 28 71 87 72
45 98 88 32 12 88 4 4 27 15 66 67 28 57 92 14 14 80 32 60 93 6 7 4 36 85 46 89 22 20 95 55 3 72 85 40 25 66 78 29 42 16 14 60 61 52 72 87 98 1
46 46 20 10 0 98 52 39 97 71 27 79 100 88 100 48 4 7 88 3 27 84 51 32 74 32 23 57 36 47 86 72 55 55 100 33 21 68 1 28 29 17 44 55 54 64 98 79 23 62
47 60 41 72 48 44 49 59 37 37 89 55 12 50 45 38 31 49 87 11 50 56 16 1 2 48 78 12 74 2 91 24 41 31 43 7 26 68 97 79 12 86 36 31 4 18 0 70 87 74
48 72 66 61 17 65 79 17 29 29 37 23 59 41 48 57 33 95 75 31 77 95 10 67 5 54 43 80 61 95 51 52 94 48 15 16 36 56 12 92 4 31 99 88 20 60 64 71 73 42
49 52 47 39 83 52 2 27 65 86 16 14 78 54 88 31 22 77 44 99 88 30 91 55 39 57 94 96 71 52 80 18 36 14 34 63 94 35 76 87 50 99 83 78 71 15 10 100 80 33
50 94 71 50 86 66 40 0 70 22 46 44 58 82 38 85 76 38 11 10 9 13 100 45 37 56 25 44 12 46 45 21 66 41 100 65 98 57 62 58 57 20 21 17 75 92 12 55 41 20
51 52 53 36 66 60 74 38 70 66 8 89 61 96 74 75 79 77 63 26 88 65 33 19 40 32 43 11 45 13 47 59 26 86 84 82 20 82 47 35 14 38 47 14 15 15 51 39 18 36
38 37 55 54 78 62 63 64 65 9 67 4 69 71 93 73 78 80 97 70 24 3 19 39 41 42 10 3 2 15 14 48 56 10 98 90 55 68 61 19 34 35 37 38 23 95 45 1 34 94
39 36 56 71 88 61 56 7 8 0 10 68 70 29 72 82 81 68 53 74 9 57 30 38 37 9 0 1 4 19 16 49 55 11 42 47 47 11 40 28 27 33 36 39 51 66 70 3 69 35
35 32 33 57 59 60 3 6 1 11 29 90 95 98 85 84 83 11 25 97 34 22 62 36 35 8 6 5 79 17 17 50 51 34 52 52 62 33 25 26 29 30 32 40 33 37 68 18 35 97
79 34 31 58 27 4 5 2 17 12 12 44 73 78 52 21 91 28 74 28 84 30 24 77 34 7 52 45 0 89 18 52 57 58 59 60 27 62 59 24 21 22 31 41 91 67 69 19 100 89
27 95 30 29 28 26 25 18 16 13 13 31 5 89 47 60 37 84 3 7 46 4 49 12 33 28 63 22 21 19 65 56 53 54 84 3 61 63 87 18 23 20 42 43 94 66 85 62 30 4
49 16 95 4 90 24 19 17 14 15 14 77 82 23 38 72 95 16 3 4 5 56 17 16 32 29 27 24 23 20 87 23 55 27 2 4 65 64 70 17 19 43 54 90 11 65 6 34 36 63
26 91 21 66 36 23 21 20 16 15 96 56 57 23 22 7 100 14 2 1 0 6 7 18 15 31 30 26 25 83 30 9 13 7 5 1 66 69 16 15 44 55 57 53 64 62 96 65 59 56
67 30 23 77 86 22 18 73 99 74 41 35 18 57 45 49 2 53 6 21 91 9 8 19 20 14 26 25 72 23 10 55 71 6 8 0 67 68 14 46 45 56 52 58 63 61 16 7 56 98
93 45 76 70 26 61 27 58 77 96 92 16 42 8 90 86 29 54 78 16 79 10 11 12 13 21 22 23 24 1 32 80 64 9 10 11 12 13 47 48 49 50 51 59 60 67 29 44 0 16
