153 7 6 5 6 1 2 3 150 78
9 8 166 4 7 0 3 4 5 99
65 110 161 3 2 1 119 136 6 175
110 16 134 192 125 84 106 140 7 8
172 194 90 41 98 199 120 0 1 9
156 87 178 8 21 173 148 3 2 172
176 189 185 51 132 3 113 135 71 119
124 10 143 125 24 186 1 154 84 0
118 50 195 38 184 177 109 3 2 1
166 197 94 177 173 48 76 18 3 2