100 7 81 91 16 20 62 62 100 83 69 34 38 50 95 88 39 61 38 64 44 35 50 11 10 97 97 47 94 33 90 60 44 80 95 64 5 77 37 83 22 88 60 46 4 63 74 64 46 69
7 99 72 30 17 13 64 49 27 45 43 2 0 95 79 69 19 46 23 8 69 47 67 93 95 48 28 26 57 63 26 57 10 62 19 76 50 46 31 44 33 73 51 37 79 32 5 79 71 45
78 70 56 99 12 10 14 23 43 4 3 51 28 67 61 47 89 43 11 80 13 56 14 45 29 17 78 86 96 25 28 89 77 6 80 17 75 61 87 3 95 42 56 5 44 58 74 78 9 29
77 51 86 99 11 15 9 8 5 2 20 64 86 48 38 64 25 98 54 41 22 16 29 49 16 2 18 58 14 88 87 35 4 42 46 83 88 7 90 59 22 83 17 96 57 87 37 25 40 5
28 22 8 86 98 16 7 6 35 0 1 56 94 86 15 29 64 35 62 16 13 91 61 88 91 49 63 63 86 51 22 68 57 32 42 25 84 56 3 31 85 18 1 63 42 94 45 10 83 99
76 1 1 18 17 15 5 7 79 2 83 18 55 13 61 31 43 16 15 43 40 83 77 56 73 63 20 87 4 78 77 41 91 89 77 90 10 49 87 12 58 90 66 32 22 39 16 47 40 9
96 20 19 89 7 83 6 4 3 12 18 19 60 55 57 56 78 55 83 64 15 0 17 94 89 69 6 64 48 27 25 94 79 54 1 19 93 48 20 77 96 0 63 97 3 70 90 56 22 39
9 34 21 65 15 75 19 91 43 29 72 6 30 84 7 97 41 8 12 24 59 75 41 89 37 57 40 81 89 20 78 4 59 46 69 85 87 11 89 99 7 38 4 20 32 56 15 4 13 26
54 64 52 22 24 3 41 66 49 41 74 76 24 40 4 37 50 18 49 68 63 72 54 36 38 28 91 50 36 52 68 54 9 59 57 39 42 93 83 43 31 63 73 49 45 75 2 73 49 77
10 1 10 23 0 54 0 94 24 48 82 29 26 92 42 9 12 64 68 32 84 30 40 39 35 16 37 58 76 35 69 56 7 7 49 0 1 40 1 79 51 16 1 51 73 81 95 28 61 67
51 56 71 76 60 48 16 92 49 1 22 77 2 20 68 11 26 91 79 45 42 41 80 36 39 34 33 32 31 28 27 26 25 49 15 73 1 2 3 100 23 60 29 100 68 92 86 49 40 23
77 69 76 57 8 57 70 82 24 62 86 24 63 64 2 56 63 24 46 43 44 43 39 37 35 4 19 30 29 9 72 25 65 49 6 6 5 4 13 89 11 10 40 68 29 81 55 31 41 50
91 54 60 31 10 33 96 26 46 78 22 84 7 67 45 21 92 78 38 47 100 40 38 45 46 12 0 84 24 99 24 23 22 78 7 28 15 14 75 12 9 86 11 25 96 68 45 11 5 12
8 74 46 93 18 93 29 57 73 45 37 72 96 7 7 28 89 93 48 73 41 17 43 44 98 75 85 25 15 26 100 21 58 35 8 16 87 5 43 16 8 7 72 19 19 77 71 96 51 66
57 37 58 53 97 52 0 2 12 14 13 89 52 6 98 76 47 13 76 49 44 42 83 66 34 90 31 84 46 45 20 72 27 9 9 10 12 97 49 92 6 5 0 30 43 57 36 41 19 30
87 56 72 56 71 71 3 1 15 12 11 73 51 69 47 45 8 62 50 52 43 45 50 15 19 68 67 38 97 65 97 19 17 16 95 13 11 40 10 79 62 4 38 5 80 1 14 52 61 12
31 46 18 54 91 99 5 4 6 8 27 10 4 40 12 12 16 54 53 51 46 47 60 19 9 25 72 47 45 13 32 18 77 15 14 68 9 73 41 42 21 2 3 59 84 27 13 3 48 84
96 13 74 88 0 87 6 7 5 7 9 10 58 45 69 86 85 51 55 32 48 49 42 13 63 87 79 91 35 84 13 15 30 37 39 98 99 41 68 5 1 19 0 44 49 74 58 55 91 33
81 46 0 45 92 29 96 8 11 65 45 93 57 13 94 48 57 56 94 53 50 52 59 86 38 22 35 65 71 32 22 90 61 57 36 73 18 68 87 0 52 3 40 38 97 56 70 51 46 0
96 31 87 29 19 1 42 9 10 77 51 97 40 76 68 59 58 63 76 92 53 51 32 59 6 62 42 5 25 82 38 6 40 37 13 88 54 6 12 30 38 71 90 95 18 60 54 33 71 62
57 36 87 83 68 31 33 12 91 40 24 63 62 61 60 9 60 53 36 54 57 56 9 29 17 79 6 4 3 31 47 44 65 80 81 53 74 13 84 34 32 54 25 86 7 36 49 86 95 92
0 26 55 74 83 85 80 17 88 1 0 66 64 32 35 64 44 42 13 72 55 58 59 87 10 30 7 56 3 31 5 37 58 44 16 12 49 9 68 96 15 19 38 69 49 49 35 31 1 42
52 95 52 100 23 49 69 54 58 19 2 65 24 74 8 73 82 44 97 43 17 66 60 11 9 8 95 2 38 0 78 48 20 78 35 54 14 16 70 2 70 48 28 51 20 97 64 29 46 7
25 12 55 3 96 48 23 8 99 4 3 59 28 33 81 53 87 14 81 23 89 13 12 61 39 6 21 15 1 0 51 45 38 39 46 51 65 97 17 52 64 25 30 80 8 0 4 3 1 95
12 70 51 48 3 5 65 29 66 74 5 12 55 47 26 80 1 57 12 72 14 74 92 36 62 63 64 39 80 46 3 99 17 2 24 78 10 33 97 29 88 12 85 77 87 67 63 97 18 41
75 45 26 21 22 36 8 32 89 6 9 66 11 87 63 76 66 56 35 95 20 15 30 86 14 75 65 66 20 22 49 34 50 58 6 61 45 13 9 80 16 30 66 87 36 25 54 1 84 46
73 25 4 92 22 92 99 37 62 8 7 10 38 28 16 67 21 20 15 37 30 16 95 57 36 68 67 72 65 37 11 12 30 95 69 31 27 10 35 65 41 87 5 80 97 1 77 29 53 94
7 36 76 60 61 55 74 98 75 50 49 48 37 39 42 41 23 22 19 61 17 12 6 28 93 70 69 71 3 41 95 29 7 87 65 35 52 58 87 82 34 17 62 29 65 82 13 50 41 10
2 25 59 62 36 45 7 42 51 87 47 45 36 43 40 26 32 24 5 18 94 38 8 47 65 51 93 70 86 11 62 8 99 72 58 29 27 90 0 68 66 21 12 84 42 19 23 80 96 13
60 59 58 63 41 13 41 52 59 52 46 100 44 35 27 29 25 35 3 59 73 8 65 19 73 1 53 61 97 1 67 40 32 49 17 7 7 17 12 32 58 19 94 92 9 12 17 18 87 59
66 65 64 57 56 54 53 19 17 3 98 62 34 33 30 28 49 22 18 59 1 31 88 94 82 97 85 31 88 4 60 66 43 42 95 97 88 27 20 74 58 55 64 86 5 65 12 45 56 56
47 80 97 70 55 81 47 3 42 44 50 31 32 31 85 78 20 48 59 92 79 20 28 79 13 21 67 69 75 9 28 9 8 82 70 93 12 26 16 0 69 97 5 90 22 57 50 10 41 43
25 56 44 48 88 96 95 87 55 77 63 33 5 83 16 81 31 70 53 55 96 30 6 28 72 78 78 68 19 99 94 63 62 2 13 78 42 72 56 11 17 59 63 81 91 5 37 48 21 10
3 17 74 31 58 92 39 2 0 95 41 58 32 49 81 1 30 84 22 96 31 17 23 63 98 79 9 26 40 96 56 79 75 77 22 61 98 21 56 44 75 8 71 45 49 52 21 20 7 53
57 53 56 93 42 85 10 38 1 29 39 49 71 51 73 5 0 26 61 58 11 3 10 11 96 51 96 5 31 31 68 19 47 89 15 11 81 99 46 17 40 54 91 59 44 54 19 9 56 47
19 11 1 96 100 66 41 51 2 100 85 45 2 9 76 73 68 41 86 43 50 46 99 44 32 97 90 63 80 49 60 57 43 71 76 36 11 91 19 11 39 89 60 11 98 12 28 24 1 53
16 37 37 5 73 85 5 4 3 73 44 30 85 100 61 81 99 28 24 60 81 67 55 51 30 16 50 13 94 62 48 76 4 77 38 28 67 70 24 14 29 88 83 45 15 44 98 28 68 92
57 39 28 66 7 6 36 4 95 29 76 27 0 84 6 91 81 82 55 69 26 48 28 62 26 5 6 42 81 46 47 26 79 40 19 78 19 91 87 56 10 24 29 88 90 48 0 74 57 4
2 1 0 8 57 100 72 37 9 45 49 73 49 50 77 97 64 34 89 81 99 21 87 0 31 66 72 50 20 7 77 80 7 81 21 61 84 32 44 32 83 14 86 37 8 53 6 92 79 79
11 10 9 93 6 89 65 32 20 15 92 6 68 95 22 10 45 88 14 16 83 11 10 43 28 97 87 64 62 43 34 97 55 17 96 31 65 66 13 68 95 28 20 88 18 86 66 60 6 47
86 12 17 16 30 54 25 7 91 69 35 41 79 8 12 79 34 33 15 13 12 12 10 9 8 50 69 85 21 34 19 100 14 77 27 43 83 54 8 30 36 34 44 9 71 0 75 75 85 82
88 13 15 30 10 23 74 83 37 36 66 40 60 54 70 20 95 89 74 87 13 11 41 8 7 56 81 97 34 63 61 68 23 43 37 36 32 70 43 80 34 66 83 54 42 41 55 4 59 66
15 14 5 98 54 70 58 51 55 58 86 41 84 94 73 41 84 83 78 14 15 76 11 6 5 4 1 65 55 73 93 75 85 78 74 24 35 63 80 34 23 10 97 78 68 42 14 59 26 21
1 79 53 7 72 80 52 84 44 21 33 81 63 28 65 88 66 50 54 65 62 16 64 65 3 2 20 0 2 5 4 37 96 62 3 7 6 14 79 65 81 15 28 4 70 35 65 41 57 27
10 43 13 73 64 80 81 81 24 23 80 72 88 4 84 81 6 4 49 18 17 57 48 94 15 33 56 1 6 3 38 26 29 9 8 5 2 1 24 82 11 5 87 5 96 11 48 5 31 47
57 94 43 64 0 80 43 65 56 56 3 77 87 88 47 65 5 23 19 21 54 31 40 38 10 30 22 1 12 7 81 15 13 10 11 4 3 6 0 99 43 71 13 84 7 55 68 23 17 20
20 42 21 85 58 79 11 98 74 43 27 42 31 33 81 74 87 60 22 20 36 31 67 36 7 96 35 93 94 8 69 14 39 12 5 4 5 8 7 30 60 47 37 84 8 91 86 21 98 29
51 11 30 9 11 77 68 53 33 32 20 20 74 37 40 90 24 23 49 29 30 32 100 91 35 66 53 76 55 9 67 13 15 18 11 10 9 8 46 90 20 84 13 67 5 90 1 90 63 41
62 45 44 43 44 69 38 34 36 65 31 73 31 8 26 25 39 42 98 3 28 77 33 100 26 94 81 89 19 18 10 16 17 12 25 30 4 9 10 12 13 46 12 9 78 42 0 91 42 96
89 47 46 42 41 40 39 37 35 72 88 30 29 28 27 29 46 42 70 63 13 27 26 25 24 23 22 21 20 11 17 16 15 14 13 38 25 95 11 16 15 14 72 36 71 6 24 37 46 9
