92 73 81 97 23 61 72 6 79 75 87 62 62 31 31 48 3 2 3 4 5 96 12 46 95 67 57 82 97 77 45 36 95 82 8 2 19 9 58 93 21 81 84 20 74 58 56 37 68 81
23 17 46 81 31 96 87 60 100 65 97 23 80 49 68 4 6 2 2 6 57 22 92 11 38 86 26 14 18 95 53 67 94 45 84 16 98 99 9 55 68 58 97 100 55 24 11 68 82 7
71 37 28 85 49 56 81 61 97 27 7 8 8 7 4 5 3 1 7 7 89 23 65 59 31 91 28 3 10 61 48 91 77 6 96 1 72 21 84 88 25 26 89 47 27 52 93 77 68 18
78 97 23 37 78 35 12 56 33 63 7 10 9 6 5 4 6 0 8 10 75 72 94 71 15 98 94 31 45 4 76 73 7 78 68 99 48 17 14 58 48 36 25 31 97 76 84 44 17 37
87 27 67 8 97 1 26 56 26 7 11 13 59 35 9 27 7 10 11 9 93 22 25 23 63 27 46 3 19 19 80 47 85 26 72 43 47 37 23 81 69 4 60 27 29 80 66 70 88 22
20 4 3 35 77 97 27 33 9 13 12 33 58 10 21 8 29 12 44 89 67 50 75 99 26 5 75 21 59 50 10 71 21 2 43 59 6 5 4 3 85 13 83 51 65 4 64 30 76 72
16 100 5 2 1 66 1 95 8 10 20 50 5 94 11 12 40 92 12 67 34 30 16 15 93 94 19 3 97 64 81 93 85 32 65 7 79 2 1 2 49 1 56 7 69 37 59 64 23 62
75 34 6 0 71 2 44 7 11 9 11 74 68 14 84 13 41 60 32 41 20 21 11 94 20 91 57 20 58 89 85 74 10 9 8 9 8 26 0 15 94 18 83 63 36 15 59 80 31 82
33 7 84 76 1 3 6 10 59 12 10 12 29 96 14 92 14 36 63 29 69 34 91 65 89 56 56 20 12 30 19 11 100 34 10 14 13 1 53 65 68 95 40 2 29 21 31 11 69 43
78 8 93 77 10 5 4 87 77 13 11 49 15 84 30 14 23 46 80 1 92 12 16 15 4 17 91 18 54 9 82 12 35 1 15 11 12 40 40 34 14 95 16 72 97 24 94 97 81 38
65 40 99 10 9 17 16 15 14 63 17 75 3 83 26 70 97 22 34 85 33 53 2 78 100 90 86 32 39 65 80 65 13 18 16 18 38 25 36 37 42 79 99 42 34 0 63 79 69 71
54 67 11 13 8 7 6 5 91 64 73 66 16 1 23 64 51 29 13 94 99 30 73 55 28 90 74 18 80 11 32 82 98 61 17 7 77 70 11 34 43 95 40 19 21 30 66 21 15 6
94 35 14 12 14 1 2 4 64 50 57 73 96 6 69 33 24 34 97 61 15 23 70 67 19 96 21 34 52 63 93 20 86 18 58 29 28 15 16 63 28 42 77 12 30 35 10 93 100 70
28 15 51 51 16 15 0 3 89 87 44 43 45 67 7 13 81 50 44 93 2 46 39 68 80 79 20 24 25 23 21 26 19 3 76 21 58 12 25 83 12 17 73 54 92 95 18 98 75 67
16 27 83 17 18 33 93 52 41 100 24 36 42 70 50 95 7 0 76 23 26 86 25 57 74 32 29 26 23 22 25 28 27 4 70 0 63 84 7 91 69 80 13 11 22 91 60 34 94 77
17 32 88 19 33 40 14 84 43 15 84 79 20 61 88 77 5 95 90 29 13 21 55 18 32 30 28 27 97 55 23 24 61 2 5 51 83 81 30 34 62 9 82 84 66 88 83 7 21 20
33 21 20 75 92 35 33 50 89 69 35 17 32 98 52 40 40 4 86 88 48 3 17 38 31 33 58 26 58 30 89 98 34 67 98 39 5 65 24 50 36 79 96 73 1 75 48 22 62 15
22 96 74 3 6 60 12 95 49 85 54 25 41 64 9 20 4 62 97 72 52 38 37 36 34 42 86 44 87 52 12 30 59 15 52 98 90 87 55 53 58 37 9 2 53 43 33 19 28 26
24 23 91 78 31 37 41 67 17 46 16 85 44 100 69 19 98 6 7 54 52 59 39 35 70 66 48 10 72 22 6 88 24 59 99 46 6 54 89 33 43 66 6 85 54 61 5 74 37 75
19 0 31 61 44 35 18 69 45 100 16 0 37 58 88 95 67 5 4 65 89 40 43 42 31 35 43 66 7 76 18 28 5 17 1 8 93 83 67 47 39 41 81 78 84 90 75 35 2 20
44 96 2 44 87 11 41 63 49 60 86 2 0 25 88 20 77 3 80 46 45 44 41 62 64 51 57 16 83 64 62 57 30 95 24 23 31 81 39 34 66 76 27 24 51 89 20 75 36 36
91 6 74 52 79 51 17 62 87 93 44 8 67 54 93 83 2 1 0 47 48 49 100 95 94 68 60 69 97 73 54 58 24 7 23 94 98 5 70 37 11 51 47 29 30 3 95 7 10 68
24 89 43 5 34 57 92 43 32 29 91 6 66 47 97 42 80 35 48 38 46 79 29 34 82 64 22 81 34 29 37 69 89 19 41 22 44 22 57 81 16 37 4 58 12 78 22 67 78 17
66 71 5 99 15 63 20 51 5 10 30 47 47 92 85 68 31 86 45 35 27 71 54 31 84 30 52 94 36 10 68 70 28 77 73 93 32 17 29 74 59 45 82 8 76 61 15 24 40 8
50 99 91 15 80 62 41 75 41 74 6 76 40 26 69 93 6 57 40 100 21 4 1 36 73 19 86 14 17 76 78 32 45 61 45 28 0 23 96 9 53 97 75 94 46 68 13 82 32 4
34 12 43 71 52 21 29 75 88 90 46 100 83 77 34 99 97 38 45 2 35 26 69 2 70 97 79 57 82 28 40 87 18 11 54 72 35 94 71 56 32 7 99 92 80 16 0 63 17 27
26 57 99 20 95 24 32 59 94 82 36 72 48 44 30 42 74 49 70 65 95 85 3 43 95 43 24 14 54 20 39 6 90 90 28 88 92 74 9 37 40 43 50 12 20 42 85 6 85 51
66 25 84 75 12 43 58 45 21 74 78 50 59 37 97 80 85 37 45 30 28 42 84 55 81 96 94 0 30 2 56 71 24 25 31 27 30 57 81 65 28 2 32 49 84 52 5 8 7 90
12 70 71 0 70 82 60 73 38 10 31 78 76 62 43 59 30 87 69 49 77 69 8 40 48 88 93 30 73 14 98 54 36 38 10 19 28 22 45 90 24 94 55 57 49 4 0 1 12 68
56 88 84 30 85 42 32 11 9 36 16 17 15 52 55 83 64 16 32 78 22 45 65 60 34 72 35 96 50 58 75 84 83 13 51 49 12 80 35 88 72 74 84 95 14 3 2 16 92 12
13 42 62 5 58 88 25 65 96 30 58 12 56 31 54 34 34 70 53 31 20 22 91 73 100 29 77 37 69 30 37 13 70 21 1 36 59 86 85 3 55 53 16 48 68 85 3 45 69 49
2 55 1 67 74 87 89 53 77 91 67 24 37 55 68 79 58 94 21 23 36 26 69 75 37 98 2 54 65 48 35 5 25 3 38 54 75 1 91 0 99 30 69 72 18 75 69 35 48 17
18 11 75 15 72 26 90 46 45 5 72 90 86 23 27 90 83 17 36 2 50 10 11 87 5 3 1 65 24 44 39 87 51 24 81 98 56 87 52 40 70 67 84 59 62 63 14 15 73 38
20 8 94 34 74 58 62 0 2 68 90 25 18 94 25 93 86 27 17 7 4 9 17 6 4 41 0 76 40 54 10 85 74 82 25 90 75 27 17 40 94 28 31 52 74 53 56 35 96 50
53 20 35 20 68 8 4 3 1 86 98 14 12 41 52 91 57 56 100 62 59 62 8 7 21 1 81 21 88 65 87 76 48 29 95 79 10 72 38 90 77 42 14 17 36 55 83 60 24 32
24 99 15 11 6 5 5 40 89 36 79 34 39 13 10 10 30 74 43 62 83 19 18 12 32 18 11 98 31 84 13 33 93 45 48 97 70 49 96 63 29 80 37 37 5 28 62 94 24 49
1 4 31 67 38 7 6 7 9 52 1 66 61 49 65 11 50 97 100 12 1 90 95 79 71 2 56 56 86 25 18 37 75 36 88 58 0 61 68 33 93 67 98 58 10 80 44 48 98 8
46 38 98 95 72 51 31 8 10 45 34 95 19 40 83 25 12 5 4 70 5 16 39 21 3 63 12 27 33 1 71 22 69 63 68 13 2 8 0 21 14 95 3 16 82 6 41 23 10 30
18 13 4 86 55 72 59 11 53 28 29 49 80 54 55 82 12 36 89 44 6 58 39 37 95 36 63 67 53 59 30 13 26 47 76 22 47 61 68 34 96 93 62 29 23 34 22 44 15 49
58 53 53 89 73 39 12 75 85 21 62 25 42 63 98 25 77 84 15 0 89 69 13 36 99 38 52 38 74 44 21 83 95 38 38 89 75 70 26 32 78 74 80 39 24 63 25 58 96 36
71 75 22 26 70 13 20 91 89 81 90 38 7 52 14 3 28 65 56 90 88 18 58 13 61 21 93 98 37 33 66 89 16 44 36 56 6 13 58 12 80 79 93 93 48 53 44 59 23 16
9 66 69 25 41 48 34 86 73 93 66 79 39 48 87 3 20 42 33 94 53 73 74 64 31 40 75 43 28 71 56 100 27 68 21 37 81 90 38 76 15 28 9 15 38 34 51 8 16 0
33 3 14 28 59 96 97 27 25 56 98 81 77 67 91 43 97 66 96 20 88 51 61 3 39 66 75 18 58 19 12 18 17 100 94 68 89 10 56 35 10 14 55 73 38 92 52 6 93 76
37 84 59 96 58 21 62 49 97 64 44 57 48 56 16 44 49 14 47 98 38 97 92 76 18 5 62 97 86 63 10 86 91 18 43 44 41 58 64 56 69 83 19 37 49 40 11 91 25 15
92 53 62 1 5 16 62 72 38 69 47 43 10 45 13 7 88 83 20 73 82 78 0 3 78 8 34 87 37 74 21 85 70 69 51 31 41 41 40 64 77 75 15 42 18 97 6 44 80 54
81 55 18 95 78 6 65 70 48 95 49 41 91 75 76 65 60 75 79 83 35 45 48 20 49 14 8 84 52 38 95 98 57 42 58 38 43 18 65 16 35 64 73 36 76 41 18 67 97 49
51 60 15 57 7 13 5 4 3 53 90 58 50 7 3 34 23 32 29 45 73 58 85 47 46 16 75 33 64 57 64 41 31 26 46 92 52 15 89 57 1 39 40 54 39 0 84 21 56 60
76 20 15 82 12 8 9 1 2 69 8 5 65 67 7 49 12 38 24 73 82 84 44 62 18 8 50 73 14 53 52 3 44 53 71 48 92 39 61 19 83 85 88 18 59 32 56 54 31 31
50 62 23 73 11 10 0 32 36 67 49 82 58 37 54 59 69 56 23 75 95 64 39 11 4 79 84 61 6 16 2 1 4 22 0 59 59 77 51 44 18 92 30 26 30 79 72 2 13 37
55 40 78 55 49 68 75 98 15 22 30 47 13 28 18 31 55 67 95 40 79 19 20 35 74 63 37 42 49 27 1 0 6 5 21 72 74 29 20 70 34 60 85 21 44 57 54 67 2 46
