90 141 153 185 69 9 25 56 100 66 65 91 85 101 136 20 119 159 155 179 168 99 43 33 38 46 153 36 59 129 161 114 198 88 41 119 122 22 37 158 196 163 185 72 195 131 7 194 20 197
199 195 61 104 35 200 6 145 108 50 7 6 5 157 97 158 1 87 44 79 1 113 66 87 175 84 15 192 83 195 108 160 190 97 3 9 82 52 41 30 56 197 99 64 110 188 18 42 146 87
92 123 187 54 47 93 82 11 10 9 8 2 157 4 106 191 96 150 70 156 52 56 135 8 65 135 72 134 1 26 8 24 173 168 128 60 29 63 3 155 125 106 125 169 168 15 85 0 4 77
92 31 127 89 191 188 41 11 124 9 0 1 3 44 172 150 11 2 149 156 120 78 0 159 76 111 177 64 98 142 121 117 176 79 95 13 152 58 80 8 79 143 9 111 20 130 136 1 95 27
45 53 106 20 91 173 72 165 10 185 84 173 2 61 183 181 47 197 137 199 120 79 179 182 110 49 109 28 173 95 187 22 64 59 164 178 177 162 109 177 77 184 156 40 191 141 187 3 2 20
180 200 133 160 143 76 76 161 56 191 72 182 26 19 57 134 186 129 121 34 31 31 111 59 107 144 5 167 90 197 131 133 78 159 89 162 80 133 34 36 90 78 20 50 58 20 107 4 144 66
85 153 22 142 64 185 58 146 141 20 196 158 122 115 117 121 45 55 77 27 175 34 158 195 154 37 191 54 129 132 137 73 57 195 200 145 138 119 122 162 102 29 129 172 164 88 5 6 22 128
9 1 151 119 19 157 46 94 81 3 39 60 48 11 43 119 71 100 199 199 65 89 117 118 23 158 92 5 117 67 12 100 107 175 92 28 27 31 25 46 139 55 154 16 181 181 7 36 164 162
175 138 192 103 31 48 8 20 147 65 190 182 104 119 178 123 192 49 21 20 19 132 22 50 10 8 7 188 21 157 143 96 141 135 20 196 29 26 24 20 91 179 84 149 11 10 8 149 66 113
16 33 111 84 6 36 78 50 68 22 41 75 110 6 5 6 5 56 166 21 18 16 12 11 9 183 180 6 5 87 129 102 126 28 197 32 30 23 159 21 22 19 168 12 11 122 9 1 121 35
20 110 16 106 176 78 168 88 138 15 15 143 99 2 7 4 35 132 22 97 17 15 14 13 73 157 67 2 4 0 57 64 134 186 33 31 31 64 22 21 20 18 13 16 15 29 12 114 136 147
70 2 93 97 99 61 33 119 193 180 179 25 98 1 3 107 152 4 67 23 111 15 16 59 75 42 121 3 1 7 87 93 131 181 33 32 95 105 129 198 27 18 17 14 8 20 166 32 193 176
124 47 100 186 184 123 99 96 23 82 181 1 121 7 0 36 12 26 24 200 86 17 73 126 11 17 86 4 171 8 38 10 184 88 87 34 33 98 197 84 115 169 120 185 106 19 68 50 126 73
86 141 59 115 197 69 58 106 187 3 5 106 133 31 30 29 25 25 21 22 18 22 177 50 48 6 5 8 9 177 121 60 26 39 35 5 25 47 19 32 112 19 0 1 182 30 23 59 144 133
22 93 10 195 104 46 104 35 170 141 180 51 81 32 28 27 26 24 23 20 19 52 200 105 126 51 7 10 69 175 179 51 40 36 38 36 119 10 100 110 14 19 166 84 137 133 163 10 9 119
161 55 69 177 53 81 172 95 137 180 114 34 33 157 112 70 112 119 188 88 83 168 142 149 132 0 11 4 29 26 108 53 41 49 122 37 48 173 165 95 72 29 40 28 134 172 133 28 70 197
158 81 144 68 183 0 81 21 51 3 35 150 200 12 38 143 131 26 16 115 100 158 92 5 180 168 174 41 88 53 41 42 191 59 135 40 121 89 45 26 161 55 51 148 94 17 54 68 143 113
62 131 182 177 57 1 168 40 98 36 37 118 48 151 188 135 12 55 19 107 200 200 3 200 54 156 7 125 159 189 43 90 90 130 178 197 197 112 131 78 62 118 189 152 37 30 39 125 54 125
32 162 8 105 191 90 2 188 39 38 193 197 150 100 56 196 42 177 113 38 175 60 108 105 22 197 190 24 76 44 45 57 88 53 10 69 199 110 81 145 72 48 6 89 23 49 108 33 77 30
168 90 9 7 8 3 177 40 136 178 14 168 11 16 154 177 48 147 113 177 167 66 177 186 100 86 185 169 47 46 41 126 188 176 103 112 151 194 104 1 198 147 147 176 117 125 35 35 111 113
130 10 11 6 5 4 45 193 147 56 21 130 140 17 70 66 131 95 139 133 82 102 107 67 76 23 51 50 49 48 145 117 1 48 97 192 1 157 10 154 102 15 117 16 99 115 60 183 117 29
14 12 8 7 6 5 7 59 150 146 160 112 114 117 171 93 186 127 5 2 84 81 102 2 139 52 50 179 70 28 138 41 32 25 14 6 39 103 25 11 136 65 138 141 0 113 102 77 17 73
15 14 13 12 59 46 6 8 162 158 57 141 120 121 96 143 2 68 92 193 145 15 154 80 116 163 81 138 44 99 125 162 183 62 133 147 189 14 45 152 197 161 63 20 194 21 129 47 166 156
23 24 11 10 9 7 56 73 9 21 5 21 16 62 61 119 42 9 186 78 120 152 29 109 56 163 42 185 110 135 142 141 64 147 199 8 110 104 159 148 116 7 106 24 64 123 98 196 5 4
25 22 21 20 8 18 17 96 133 10 29 104 159 173 18 182 99 0 2 24 71 130 44 17 7 1 96 157 20 71 29 107 65 28 17 22 182 24 15 37 61 4 108 134 173 135 150 136 188 7
24 23 98 20 19 18 16 15 12 11 193 170 94 38 108 155 66 48 112 23 37 35 131 153 141 5 194 61 110 76 33 68 97 126 80 71 146 143 49 184 144 114 77 58 185 123 7 115 23 106
6 5 4 3 1 0 14 13 14 13 12 95 181 54 116 35 88 42 93 45 51 155 96 186 125 74 89 175 45 17 15 197 159 196 96 111 191 70 194 74 159 76 194 2 199 75 39 38 60 10
7 2 3 2 108 18 17 16 15 80 21 159 82 13 11 198 81 33 124 50 59 134 50 143 142 31 66 164 73 170 8 133 4 94 176 187 156 13 114 88 58 41 121 147 97 49 161 1 85 53
186 4 1 0 79 104 19 21 26 145 190 150 77 30 29 82 117 196 102 133 50 29 11 59 173 7 69 51 150 118 91 87 176 132 45 161 91 46 25 160 66 56 99 99 162 150 152 88 198 119
5 22 154 148 171 36 165 20 35 163 177 190 149 169 101 179 199 182 48 115 194 21 101 182 101 43 111 195 38 175 86 101 118 200 41 101 115 125 155 142 181 6 111 142 164 121 171 126 130 175
6 138 172 91 75 16 96 138 150 35 122 121 76 10 108 159 135 172 132 128 161 179 10 188 200 52 57 171 19 125 189 167 115 118 171 47 162 107 76 23 70 178 42 58 79 8 140 195 200 90
43 89 107 40 110 156 103 5 99 97 5 92 182 79 138 120 77 111 10 99 26 35 75 188 82 22 125 27 34 42 163 87 195 79 144 88 189 167 7 147 195 141 48 169 74 87 31 90 23 131
79 165 158 169 13 142 72 25 12 194 109 47 47 191 144 42 163 52 122 57 37 74 86 80 117 56 176 168 82 191 156 91 172 181 112 117 197 141 59 57 197 50 84 104 170 58 175 115 0 131
21 54 165 156 62 189 134 25 107 102 152 183 90 24 78 147 16 22 17 61 180 176 189 88 104 41 63 70 36 24 45 24 55 200 60 48 110 57 47 171 27 197 113 11 128 90 17 1 2 32
173 39 3 82 145 166 115 158 44 112 13 137 184 189 44 74 33 112 112 110 48 2 123 169 68 145 87 128 34 113 107 29 83 155 196 26 129 2 138 190 158 179 108 37 140 6 133 188 3 28
2 181 198 93 101 98 173 38 40 61 41 164 137 154 199 195 109 14 55 116 82 8 7 85 5 4 104 58 100 57 30 17 189 131 97 58 192 29 4 200 12 106 0 93 7 8 5 4 173 138
133 199 20 28 75 0 191 124 17 75 178 119 135 13 131 118 10 4 13 11 10 9 0 6 3 159 103 3 42 80 0 2 101 25 6 175 41 107 99 59 146 121 196 14 0 10 9 187 11 44
144 114 181 168 13 134 180 30 181 127 200 94 0 107 49 27 96 92 12 46 124 182 164 1 2 134 57 77 136 152 134 188 162 100 63 57 123 60 107 99 190 38 148 72 13 119 11 79 166 130
188 91 0 128 120 171 143 176 36 140 29 51 108 198 126 24 12 120 9 103 144 193 108 2 83 165 50 10 199 145 76 182 147 78 40 186 197 197 118 43 49 189 49 94 184 12 60 8 189 179
3 2 186 52 32 116 81 198 190 60 147 143 61 131 12 11 13 76 93 69 6 188 180 117 103 9 0 98 182 101 111 55 133 140 90 193 83 114 120 96 60 53 193 85 34 38 90 57 169 196
1 0 124 26 13 151 66 182 173 110 98 169 167 13 55 14 10 158 162 82 115 129 27 186 142 189 71 90 115 111 154 41 187 23 6 17 157 44 126 93 118 49 43 87 4 9 9 114 145 137
37 2 158 1 199 162 15 122 151 182 49 125 94 192 14 9 15 80 111 55 116 21 21 172 6 6 57 103 26 85 22 133 66 20 148 130 192 79 40 76 191 165 189 151 144 148 9 58 19 195
3 196 136 39 0 54 133 65 62 22 21 20 18 15 16 8 1 2 173 53 95 118 105 36 147 76 197 130 99 84 78 15 150 139 187 184 64 172 3 143 98 166 179 2 77 182 77 44 128 108
176 196 172 49 196 3 170 158 23 84 185 19 162 17 158 83 7 0 1 101 193 49 64 33 63 61 111 130 108 183 113 130 96 56 136 107 20 45 29 154 162 15 193 14 48 136 95 4 88 12
81 129 31 51 154 196 67 24 121 159 85 58 200 52 43 6 5 2 39 21 199 174 136 33 59 24 167 42 54 32 81 23 163 103 43 188 131 95 54 80 184 180 65 59 1 89 81 25 10 183
178 109 15 132 64 134 146 26 25 71 29 78 18 86 137 4 3 97 124 77 18 44 175 166 106 51 84 148 140 4 49 78 169 36 70 62 44 136 98 165 103 25 7 69 183 100 138 157 155 92
49 174 49 9 157 78 169 34 27 29 75 115 186 175 199 19 82 39 17 167 175 114 161 128 27 38 125 36 113 7 109 149 19 111 190 150 136 46 178 57 167 135 130 138 16 15 60 45 116 79
33 87 106 157 68 56 73 52 28 93 165 165 183 158 14 110 58 44 102 4 63 126 67 11 179 2 138 93 55 88 184 170 200 116 76 100 199 130 170 188 39 140 101 86 37 43 95 172 103 132
176 88 187 45 170 135 44 140 28 128 42 43 58 56 191 58 162 44 186 67 21 162 11 66 127 38 80 13 64 48 196 179 159 48 51 186 147 77 112 57 87 112 51 195 52 154 41 88 53 69
105 104 99 10 153 112 14 133 110 170 175 64 13 142 115 199 24 67 118 32 103 85 197 35 47 153 76 81 28 120 7 104 35 150 164 157 50 180 198 144 25 157 12 103 123 100 65 51 12 52
