8 12 6 17 7 17 16 6 19 5
13 5 3 16 0 1 2 2 13 2
0 19 6 5 4 1 16 13 16 2
10 11 7 3 2 2 4 8 14 4
9 8 18 16 3 5 8 2 2 17
20 19 15 17 4 20 16 12 18 1
15 14 8 3 20 6 13 10 2 8
13 10 9 12 17 17 3 7 1 10
7 12 11 8 17 9 15 4 3 8
4 11 14 19 7 6 5 2 1 0
