6 3 2 2 0
7 4 3 1 9
7 3 6 4 1
2 1 0 4 4
1 0 2 5 0
