96 41 178 161 140 66 49 49 56 175
118 143 172 83 159 76 21 14 1 9
73 97 7 127 51 175 113 66 131 171
149 0 199 163 76 34 50 56 152 66
4 2 1 39 137 132 50 51 41 53
3 130 193 171 0 1 165 163 1 112
136 40 4 3 2 6 198 2 0 61
148 190 4 3 7 107 5 3 49 57
143 185 51 8 178 2 69 4 44 145
131 0 9 96 47 112 135 21 58 148
